1111111111111111111111111
1010010100100C00101001001
101001001010101C000100101
1P0000000000C0000E0000001
1111111111111111111111111