111111111111111111111
100000000000000000001
100000000000C00000001
100000000000000000PE1
111111111111111111111