11111111111111111111
1P100000C000000000E1
10000000000000000001
10000000000000000001
11111111111111111111