111111111111111111111
100000000000000000001
10000000P000C00000001
1000000000000000000E1
111111111111111111111