1111111111111111111111
1000000000000000000011
100000000000000000PE11
1111111111111111111111