1111111111111111111111111111111
1P000000000000000N0000000000001
100C000C00C0000C000C000C0000001
100C000C00C0000C000C000C000N0N1
100C000C00C0CC0C000C000C0000E01
100CCCCC00CC00CC000CCCCC000N0N1
1000000000000N0000N000000000001
1111111111111111111111111111111