1111111111111111111111111
1010010100100C00101001001
101001001010101C000100101
1C0000000000C000000000001
1C0000000000C00000E000001
1C0000000000C000000000001
1C0000000000C0000000N0001
100000000000C000000000001
1000P0000000C000000000001
1111111111111111111111111